w                              w
w                              w
w                              w
w                              w
w                              w
w                              w
w                  w           w
w      www  www wwww           w
w  w                           w
w  w                           w
w  w                           w
w    ww                        w
w        www wwww   www        w
w                        w     w
w                       ww     w
w s       e     w     wwww     w
w  w      n    www             w
wwwwwww wwwwwwwwwwww  wwwwww  ww
